NO textures/no.xpm
SO textures/so.xpm
WE textures/we.xpm
EA textures/ea.xpm

F 122,168,60
C 137,189,222

1111111111111111111
1000000101000010001
1010001000000000001
1000000000011110001
10000000N0000000001
1100000000000000001
1000010000100010001
1100010000010000001
1000000000001000001
1111111111111111111
