NO textures/no.xpm
SO textures/so.xpm
WE textures/we.xpm
EA textures/ea.xpm

F 220,100,0
C 225,30,0

111111111  11
1111000000001
1001100000001
10011100N0001
1111 1111111
