NO textures/no.xpm
SO textures/so.xpm
WE textures/we.xpm
EA textures/ea.xpm

F 220,100,0
C 225,30,0

111111111111111111111111111
11100000000000000000111111111111
111111100000000000000000110011111
10001111111111111100000011111
 1111111100000000N0000000111111111111111
1111111110111100000000000000000111
1111111111111111111111111111111111111
